NO textures/qr2.xpm
SO textures/wolf1.xpm
WE textures/wolf2.xpm
EA textures/wolf3.xpm
F 11,169,20
C 153,204,255

111111111111111111111
111111000000001111111
111111000000001111111
100000000N00000000001
100000000000000000001
111110000000001111111
111110000000001111111
111111111111111111111
