
NO textures/test/north.xpm
SO textures/test/south.xpm
WE textures/test/weast.xpm
EA textures/test/east.xpm

C 53,41,34
F 45,33,27


111111111111111111111111
100000000000000000000001
100000000000000000000001
100000000000000000000001
100000000000000000000001
100000000000000000000001
10000000000W000000000001
100000000000000000000001
100000000000000000000001
1111111111111111111111111