NO textures/blue.xpm
SO textures/green.xpm
WE textures/pink.xpm
EA textures/purple.xpm

F 255,229,211
C 211,252,255

11111111111
11110001111
11110001111
11110001111
10000000001
10000N00001
10000000001
11110001111
11110001111
11110001111
11111111111
