NO textures/wolf1.xpm
EA textures/wolf2.xpm
SO textures/wolf3.xpm
WE textures/wolf4.xpm

C 35,19,73
F 15,6,40

111111111111111
1000000000000001
1000000000000001
1000000000000001
1000000000000001
1000000N00000001
1000000000000001
1000000000000001
1000000000000001
1000000000000001
1000000000000001
1000000000000001
111111111111111
