NO textures/test/north.xpm
SO textures/test/south.xpm
WE textures/test/weast.xpm
EA textures/test/east.xpm

F 11,169,20
C 153,204,255

111111111111111111
100000000000000001
1S0000000000000001
111111111000000001
111111111000000001
111111111111111111
