11111111111
10000000001
10011000001
10011000001
10000000001
1N000000001
10000000001
11111111111